111111111111
10000000001
111000000011
100PC0000001
1000000E0001
111111111111
