1111111111
100C0P0E11
1111001111
