11111111
10000001
00000001
000C0PE1
11111111
