1111001111
100C0P0E11
1111111111
