11111111
11000011
11PE1111
11111111