111111111111111
10000000P000001
1CC000000000001
100000000C00C01
111000011100001
10000000E000001
111111111111111
