1111111111
1L01111111
1E11111P11
111C000001
1111111111
