1111111111
100P000C01
1000000001
10C0000C01
100100E001
1110000111
1100000001
1111111111
