11111111111111111111
1000C000000000000001
10000000000000001111
100000000000000C0001
10000000000000000001
111110000000E0000001
10000000000000000001
100000000000000C0001
10000111100000000001
10000000000000000001
100C0000000000C00011
1000000C000000000001
10000000000000000001
1000000C000001111001
10000000000C00000001
100010000000000C0001
1000000000000C000001
100000000P0000000001
11111111111111111111
