11111111111111111111
1000000C000010000101
10000000000000000001
10111111111111111111
10000000000000000001
11111111111111111101
10000000000000000001
10111111111111111111
10000000000000000001
11111111111111111101
10000000000000000001
10111111111111111111
10000000000000000001
11111111111111111101
10000000000000000001
10111111111111111111
10000000000000000001
11111111111111111101
10000000000000000001
10111111111111111111
10000000000000000001
11111111111111111101
10000000000000000001
10000000000000000001
100000001P1010100011
11111111111111111111
