1111111
1000C01
100E001
1P000C1
1111111
