11111111
10000000
10000001
100C0PE1
11111111
