11111111
00000001
10000001
100C0PE1
11111111
