1111111111
100C0P0E11
1111101111
