111111
1P1111
101111
1C11E1
111111
