111111111111111111111111111111111
111111111111111111111111111111111
10000000CCCOOCOCOOOCOCCOCOCOCOC11
11OOOCCCOOOOOOOOCCOCOCOCOCOCCOCP1
111111111111111111111111111111111