1111111111
100F000001
1000000001
10C0000001
100000E001
1111111111
