1111111111
100P000001
1000000001
10C0000001
100000E001
1110000111
1100000001
1111111111
