1111111111111111111111111111
1111111111111111111111111111
1111111P00000000000000100111
110000000000011000000C00C111
110000000000011000000C000111
110000000101001001E101011111
1111111111111111111111111111
